1111111111
1111111111
1110001111
1110001111
1111001111
1111001111
1111001111
1111111111
1111111111
1111111111

2
wwww
42
wwww
43

2
33
52

32
