1111111111
1000000111
1000000111
1110000111
1110000111
1110000111
1111111111
1111111111
1111111111
1111111111

4
w
32
w
43
w
44
w
34

4
11
12
21
22

35
