1111111111
1000000111
1000000111
1110000111
1110000111
1110000111
1111111111
1111111111
1111111111
1111111111

4
wwww
32
wwww
43
wwww
44
wwww
34

4
11
12
21
22

35
