1111111111
1100011111
1100011111
1110010011
1110000011
1000111011
1000111011
1000111111
1111111111
1111111111

3
w
44
w
25
w
26

3
74
75
76

32
