1111111111
1000000011
1000000011
1110000011
1110000011
1110000011
1111111111
1111111111
1111111111
1111111111

4
w
42
w
53
w
54
w
44

4
11
12
21
22

45
